
Productos Orgánicos (Section/Subsection/Paragraph/Subparagraph)

AGRICULTURA: 
Agricultura convencional: Conventional farming
Agricultura orgánica: Organic farming
Alelopatía: Allelopathy
Almácigo: Seeding
Arrastre del suelo: soil erosion
Brote: Shoot
Cercos vivos: Living fences
Cultivo de cobertura: Cover crop 
Cultivo perenne: Perennial crop
Cultivo sin suelo: Soil less cultivation
Cultivo: crops/cultivation BUT Cosecha: Harvest
Desarrollar cultivos vinculados al suelo: Grow crops in soil
Desmonte: ?
Establecimiento agropecuario: (agricultural and livestock) Holding/Plant/Establishment
Explotación agropecuaria: Farm
Forraje perenne: Perennial forage
Invernáculos: Greenhouse (heated by the sun) / hothouse (heated by artificial resources)
Labrar: To till / Laboreo: tillage
Maceta: Pot
Material de propagación vegetativa: Vegetative propagation material
Acolchado: Mulching
Nutrición vegetal: Plant nutrition
Organismos modificados genéticamente (OMG): Genetically modified organisms(GMO)
Parcela: Land parcels
Pastizales: Pasturages
Período de cultivo: Growing period
Plaga: Pest
Plantas adultas: Mature plants
Plantas de raíces profundas/superficiales: deep-rooted/shallow-rooted plants
Pradera: Grassland
Producción de forrajes: fodder production
Producción de pastos: pasture production
Producción vegetal: Plant production
Quitosano: Chitosan
Recolección: harvest (agricultura y acuicultura)
Restos de vegetación: Green waste
Rotación plurianual de cultivos: Multianual crop rotation
Siembra: Sowing
Soluciones nutritivas: Nutritive solutions
Sombreado: Shading
Suelo: Soil
Tierra de diatomeas: Diatomaceous earth
Vivero: Nursery

APICULTURA
Alza malaria: Super hive
Apiario certificable: Certifiable apiary
Cámaras de cría: Brood chambers
Cera: Honeycomb
Colmena: Beehive
Colonia: Colony
Cuadros: Frames
Materia vegetal/animal/orgánica: Plant/Animal/Organic matter BUT Materia prima/inerte/viva: Raw/Inert/Live material
Material vegetal: Plant matter (NO VEGETABLE)
Paquete: Package
Pisos: Hive stands

GANADERÍA
Alojamiento: Housing
Amamantamiento: Milking 
Animales estabulados: Housed animals
Bienestar animal: Animal Welfare 
Bolsón: Wool pack
Camada/Cría: Brood/Young
Carnero: Ram
Cría: Husbandry
Criar: to rear
Descole/Caudotomía: Docking
Destete: weaning / Destetar: To be weaned
Encarnerar: Tupping
Engorde de ganado intensivo a corral: Fattening of livestock in feedlots
Esquila: Shearing 
Establecimiento agropecuario: Holding
Estabulación: Stabling
Explotación agropecuaria: Farm
Fardo: Bundle
Gallina ponedora: Laying hen 
Gallinero: Poultry house 
Ganadería extensiva: Extensive farming
Ganadería intensiva: Factory farming
Ganado: Livestock
Hembra reproductora: Breeding female (lo mismo para male)
Hembras nulíparas: Nulliparous females
Lactante: Nursing/milking animal
Laparoscopía: Laparoscopy
Lazareto: Lazaretto
Lienzo: Hessian bags
Local: livestock building
Madre sustituta: Surrogate mother 
Majada: Flock
Mamar: To suckle
Medicamentos veterinarios: Veterinary drugs
Medicina veterinaria: Veterinary medicine
Período de lactancia: Lactation period
Peso vivo: Live weight
Pezones (de animals): Teats (Nipples NO, es para humanos)
Pienso (alimento para animales): Feedstuff BUT Alimento (para humanos): Foodstuff
Plantel: Breeding stock
Prácticas pecuarias/ganaderas/zootécnicas: Husbandry practices (cría) / Livestock production (ganadería)
Producción ganadera sin terreno: Landless livestock production
Producción primaria: Primary production
Ración base: Staple food
Ración total: Total ration
Ración: Portion
Reposición de animales: Restocking of animals / Reponer: To restock
Rodeo: Livestock (del país) / Herd (de un establecimiento)
Rotación en los lotes de pastoreo: Rotational grazing
Señal: Earmarks
Servicio (reproducción): Service
Sincronización del celo: Synchronization of the oestrus cycle
Sobrepastoreo: Overgrazing
Tambo: Dairy (place) / Milking (process) 
Tierras de pastoreo: Rangelands
Vellón commercial: Commercial fleece
Zona al aire libre: Outdoor area
Zona cubierta: Indoor area

ACUICULTURA
Ablación penduncular simple: Eyestalk ablation
Acuicultura multitrófica integrada: Integrated multi-trophic aquaculture
Acuicultura: Aquaculture BUT Acuicultural: Aquaculture
Agua de mar: Sea water
Agua dulce/marina: Freshwater/marine water
Agua residual: Wastewater
Aguas interiores: Inland waters
Áreas continentales/marinas/marítimas: Continental/maritime areas
Bandejas: Trays
Barbecho: Fallowing
Bateas/balsas: Rafts
Cercados de malla (en el mar): Net pens/bags (at the sea) 
Ciclo de producción: Production cycle
Corral: Pen
Criadero: Hatchery
Cuerdas colgantes: Drop-ropes
Cuerdas: Long-lines
Cuerpos de agua: water bodies
Cultivo en el fondo: Bottom culture
Densidad de población: Stocking density
Ensilado de pescado: Fish silage
Esmoltificación: Smoltification
Estanque: Pond
Eutrofización: Eutrophication
Fase de crecimiento: Grow-out phase
Ginogénesis: Gynogenesis
Hidrolizado de proteínas de pescado: hydrolized fish proteins 
Incubación: Hatching
Jaula: Cage
Linternas: Lantern nets
Mástiles: Bouchot poles
Material reproductivo: Broodstock origin
Napas de agua freáticas: Groundwaters
Pesca sostenible: Sustainable fishery 
Población: Stock
Policultivo: Policulture
Recinto: Enclosure
Rendimiento de la explotación: Farming yield
Sal gema bruta de mina: Coarse rock salt 
Sal marina: Sea salt
Sésil: Sessile
Sistema de contención: (Closed) Containment system
Sistema de producción acuícola orgánica: Organic aquaculture production system
Sistema de producción en tierra: Land-based production system
Sistema de producción flotante: Water-based production system
Sistema de producción sobreelevado: Off-bottom production system
Sistema de recirculación cerrada: Culture in recirculating systems
Sistema en ambientes naturales controlados: Static water pond
Unidad de cría: Rearing unit
Zonas de marea: Tidal zones

FERTILIZANTES 
Abono verde: Green manure
Biol: Biol
Bocashi: Bokashi
Compost: Compost
Estiércol compostado: Composted farmyard manure
Estiércol de granja desecado: Dried farmyard manure
Estiércol de granja: Farmyard manure
Estiércol: Manure (abono) / Dung (excremento)
Fertilización de síntesis: Synthetic fertilization
Fertilizantes foliares (origen natural): (natural) Foliar fertilizers
Gallinazo: Poultry manure
Guano: Guano
Mantillo de excrementos sólidos: Composted animal excrements
Purín: Slurry

VINICULTURA
Viti: producción primaria en parrales
Vitivini: producción de la uva + bodega
Anhídrido sulfuroso: Sulfur dioxide
Barril/barrica: Barrel
Cápsula: Capsule
Chips and duelas: Chips and staves
Concentración parcial por frío: Partial concentration through cooling
Contraetiqueta: Back label
Crianza o envejecimiento: ? or ageing
Cuba: Tank
Cultivo de la vid: Harvest of the vine
Filtración amicróbica: Amicrobic filtration
Flash térmico: Laser flash
Grado alcoholico: Alcoholic strength 
Pisar uvas: Tread
Productos vitícolas: Grapevine products
Tapón: Cap
Tonel: Cask
Vid: Vine

OTROS
Aditivo alimentario: Food additive
Agroforestería: Agroforestry
Alimentos compuestos: Compound feed
Auditoría: Private audit
Autoridad de aplicación: Enforcement authority
Ayurvédico: Ayurvedic 
Biodiversidad: Biodiversity
Certificación: Certification
Coadyuvantes (tecnológicos): Processing aids
Condiciones de uso: Terms of use
Contrato de aparcería: Sharecropping agreement
Contrato de arrendamiento: Lease agreement
Contrato de comodate: Commodate agreement
Control biologico: Biological control
Corredores biológicos: Biological corridors
Cortinas forestales/arbustivas: Shelterbelts
Cursos de agua: Waterways
Denominación: Name
Depósitos naturales: Natural deposits
Derivados (productos): Derivatives
Dispersores/dispersar: Sprays/Spread
Documentos de respaldo: Supporting documents
Ecosistemas frágiles: Fragile ecosystems
El campo en un formulario: Box
Elaboración: Manufacture
Encuesta original: Original survey
Entidad certificadora: Certifying body
Envases/contenedores: Packages/containers
Equivalente: Equivalent
Estirpe: Strain
Factor de perturbación; Disruptive factor
Fibra natural: Natural fiber
Fibra sintética: Synthetic fiber
Fibra textil de origen animal: Animal textile fiber
Fibra textil de origen vegetal: Plant textile fiber
Fiscalización: Public audit
Fotoperíodo: Photoperiod
Goma arábiga: Acacia gum
Granizo: Hail
Habilitaciones: Authorizations
Helada: Frost
Inductor: Inductor
Insectos esterilizados: Neutered insects
Insolación: Sunstroke
Intemperización: Weathering
Legajo de control: Control file
Lugar/fecha de emisión: Place/date of issuance
Medicamentos veterinarios: Veterinary drugs
Normas Generales de Elaboración de Productos: General Manufacturing Standards for Products
Núcleo: Nucleous
Número de inscripción: Registration number
Oligoelementos: Trace elements
Operador: Operator (es el productor)
Plan de producción orgánica: Organic production plan
Preparados biodinámicos: Biodynamic preparations
Preparados caseros intraprediales: Homemade intra-facility preparations
Preservantes: Preservatives
Producción silvopastoril/al: Silvopastoral production
Productos orgánicos: Organic products / Productos en conversión (a orgánicos): Products under (process of) conversion (into organic) / Productos convencionales: Conventional products / Conversión simultánea: Simultaneous conversion
Productos primarios: Primary products
Radiación ionizante: Ionizing radiation
Recolección silvestre: Wildcrafting 
Régimen de control organic: Organic control system
Responsable técnico / de calidad: Technical/Quality manager
Riego por asperción: Sprinkler irrigation
Seguimiento: Follow-up
Subproductos: By-products
Supervisión: Supervision
Trazabilidad: Traceability
Unidad de producción/productiva: Production unit
Uso interno: In-farm use
Zona de amortiguación: Buffer zones
